15.ox
........o.
...o.....o
o.......o.
...o......
.........o
....o..oo.
..........
.oo.......
.oe..o....
..........
..........
.......o..
.....o....
o.........
..........
