6.bx
..b.....b.
.......b.b
..........
..b.......
.b...bbb..
..b.......
