10123
2111211221
2122121222
2121112221
1111221111
1111211221
2221211112
1211112221
2212211112
2211112112
1111212122
